99999999999999999999999999999999999999999
19999999999999999999999999999999999999999
19999999111199999991111111111999999999999
19999999199199999991999999991999999999999
19999999199199999991999999991999999999999
11111111199199999991999999991999999999999
99999999999199999991999999991999999999999
99999999999199999991999999991999999999999
99999999999199999991999999991999999999999
99111111111199999991999999991999999999999
99199999999999999991999999991999999999999
99199999999999991111999999991999999999999
99199999999999991999999999991999999999999
99199999911111111999999999991999999999999
99199999919999999999999999991199999999999
99111111119999999999999999999199999999999
99999999999999999999999999999199999999999
99999999999999999999999999999199999999999
99999999999999999999999999999111111999999
99999999999999999999999999999999991999999
99999999999999999999999999999999991999999
99999999999999999999999999999999991999999
99999999999999999999999999999999991111111
